1 3 4 3 5 3 3 3 5 3 3 3 1 1
1 9 0 9 9 9 9 9 9 9 9 9 1 1
1 0 0 0 0 0 0 0 0 0 0 0 11 1
1 0 0 0 0 0 0 0 0 0 0 0 11 1
1 6 10 3 7 3 7 3 7 3 7 3 8 1
1 9 9 9 9 9 9 9 9 9 9 9 9 1
1 1 1 1 0 0 3 0 0 0 1 1 1 1
1 2 0 0 0 0 9 0 0 0 0 0 2 1
1 1 1 1 0 0 0 0 0 0 1 1 1 1
1 1 1 1 3 3 7 3 3 3 1 1 1 1

